WWWWWWWWWWWWWWW
WP    BBB BBBBW
W W W W W W W W
W      B  B B W
WBW WBW W WBW W
W          B  W
W WBWBW WBWBWBW
WBBBBB R B    W
WBW WBW WBW W W
W   BYBB   B BW
W WBWBW W W W W
W  B     B   GW
WWWWWWWWWWWWWWW